Anexo|ax
Anúncio|an
Artigo original|oa
Atualização|up
Carta|le
Comentário|co
Comunicação breve|sc
Editorial|ed
Ensaio clínico|ct
Ensaio controlado|tt
Entrevista|in
Informe técnico|tr
Metodologia|mt
Nota|rn
Ponto de vista|pv
Relato de caso|cr
Resenha|rc
Resumo|ab
Revisão |ra
ax|Anexo
an|Anúncio
oa|Artigo original
up|Atualização
le|Carta
co|Comentário
sc|Comunicação breve
ed|Editorial
ct|Ensaios clínicos
in|Entrevista
tr|Informe técnico
rn|Nota
mt|Metodologia
pv|Ponto de vista
cr|Relato de caso
rc|Resenha
ab|Resumo
ra|Revisão

